1111111111
100E000101
1011111101
1000000001
1P00000111
100C000001
1111111111