11111111
10000E01
10000001
10000001
10C00001
10000001
10000P01
11111111