1111111111
10000001E1
1011111101
1000000001
1P01000111
100C100001
1111111111