1111111111
1000000001
10C0000E01
1000000001
1000000001
100C000001
1000000001
1000000001
1000000C01
1111111111
