11111111111111111111111
100000C100000000000C1E1
10000111000000011111101
10000000000000000000001
1P000001000000000000111
10000001C100000000000C1
11111111111111111111111