11111111111111111111111111111
10000000000000000000C00000001
1000P00000100C001000001000001
11111110111000100000000110C01
10000000000010000000000100001
100C00000001100000C0000000001
10000000111000000001001111001
10000000000000000000000000111
1000111000010000C000000010001
1001000C000000000001000010001
1C010000001000000000000010C01
10000010000C00000010000010001
100000100000000000100C00100E1
11111111111111111111111111111