111111111111111111111111111111111111111111111111111111111
11000000000000000000000C000000000000C00000000001000000001
110000000000000000000000000000000000000000000001000100001
110000000000000000000000000000000000000000000001000100001
110000000000000000000000000000000000000000000001000100001
1100000000000000000000000000000000000000000000010C0100001
110000000000000000000000000000000000000000000001000100001
1100000000000000000000000000000000C000000000000100010C001
110000000000000000C00000000000000000000000000001000100001
110000000000000000000000000000000000000000000001000100001
110000000000000000000000000000000000000000000001000100001
110000000000000000000000000000000000000000000001000100001
110000000000000000000000000000000000000C00000001000100001
110000000000000000000000000000000000000000000001000100001
11000000000P000000000000000000000000000000000001000100001
110000000000000000000000000000000000000000000001000100001
110000000000000000000000000000000000000000000001000100001
110000000000000000000000000000000000000000000001000100001
110000000000000000000000000000000000000000000001000100001
110000000000000000000000000000000000000000000001000100001
11000000000000000000C000000000000000000000000001000100E01
110000000000000000000000000000000000000000000000000100001
111111111111111111111111111111111111111111111111111111111