11111111111111
10000001000101
10001000001E11
10000C00000101
10P00000100001
10000100000001
11111111111111