11111111111111
10000001100001
10001000E00001
100C0000100001
10P00000100C01
10000100100001
11111111111111