11111111111111
10C00001000001
10001000000E01
1000000C0000011
10P00000100001
1000010000C001
11111111111111