11111111111111
10000001000001
10001000000E01
10000000000001
10P00000100001
10000100000001
11111111111111