111111111111
1000000000E1
10000000C001
100000000001
100P00000001
1000000x0001
111111111111